player1_id,player2_id,atp_difference,classe,proba,odds
113,103,-10,0,0.5,2.0
200,14,-186,1,0.6,1.67
27,93,66,0,0.46,2.17
29,118,89,0,0.46,2.17
429,26,-403,1,0.63,1.59
15,144,129,0,0.47,2.13
96,38,-58,0,0.49,2.04
88,99,11,0,0.48,2.08
8,95,87,1,0.6,1.67
71,2,-69,1,0.88,1.14
85,36,-49,0,0.47,2.13
148,17,-131,1,0.62,1.61
65,64,-1,0,0.49,2.04
62,73,11,0,0.49,2.04
34,49,15,0,0.49,2.04
160,19,-141,1,0.54,1.85
53,46,-7,0,0.49,2.04
108,28,-80,1,0.5,2.0
25,45,20,0,0.47,2.13
39,47,8,1,0.5,2.0
121,100,-21,1,0.5,2.0
18,91,73,0,0.43,2.33
130,112,-18,1,0.55,1.82
7,75,68,1,0.52,1.92
1,1000,999,0,0.26,3.85
1000,1000,0,1,0.51,1.96
1000,1000,0,1,0.51,1.96
44,1000,956,1,0.56,1.79
13,1000,987,0,0.29,3.45
1000,1000,0,1,0.51,1.96
1000,1000,0,1,0.51,1.96
1000,1000,0,1,0.51,1.96
1000,1000,0,1,0.51,1.96
1000,1000,0,1,0.51,1.96
1000,1000,0,1,0.51,1.96
1000,1000,0,1,0.51,1.96
1000,1000,0,1,0.51,1.96
1000,1000,0,1,0.51,1.96
1000,1000,0,1,0.51,1.96
1000,1000,0,1,0.51,1.96
1000,1000,0,1,0.51,1.96
125,4,-121,0,0.29,3.45
1000,1000,0,1,0.51,1.96
80,1000,920,0,0.29,3.45
76,185,109,0,0.41,2.44
56,1000,944,1,0.66,1.52
1000,1000,0,1,0.51,1.96
1000,1000,0,1,0.51,1.96
1000,1000,0,1,0.51,1.96
1000,1000,0,1,0.51,1.96
1000,1000,0,1,0.51,1.96
1000,1000,0,1,0.51,1.96
1000,1000,0,1,0.51,1.96
1000,1000,0,1,0.51,1.96
1000,1000,0,1,0.51,1.96
1000,1000,0,1,0.51,1.96
1000,1000,0,1,0.51,1.96
1000,1000,0,1,0.51,1.96
1000,1000,0,1,0.51,1.96
1000,1000,0,1,0.51,1.96
1000,1000,0,1,0.51,1.96
1000,1000,0,1,0.51,1.96
1000,1000,0,1,0.51,1.96
1000,1000,0,1,0.51,1.96
1000,1000,0,1,0.51,1.96
1000,1000,0,1,0.51,1.96
1000,1000,0,1,0.51,1.96
1000,1000,0,1,0.51,1.96
1000,1000,0,1,0.51,1.96
1000,1000,0,1,0.51,1.96
1000,1000,0,1,0.51,1.96
1000,1000,0,1,0.51,1.96
1000,1000,0,1,0.51,1.96
1000,1000,0,1,0.51,1.96
1000,1000,0,1,0.51,1.96
1000,1000,0,1,0.51,1.96
1000,1000,0,1,0.51,1.96
1000,1000,0,1,0.51,1.96
1000,1000,0,1,0.51,1.96
1000,1000,0,1,0.51,1.96
1000,1000,0,1,0.51,1.96
1000,1000,0,1,0.51,1.96
1000,1000,0,1,0.51,1.96
1000,1000,0,1,0.51,1.96
1000,1000,0,1,0.51,1.96
1000,1000,0,1,0.51,1.96
1000,1000,0,1,0.51,1.96
1000,1000,0,1,0.51,1.96
1000,1000,0,1,0.51,1.96
1000,1000,0,1,0.51,1.96
1000,1000,0,1,0.51,1.96
1000,1000,0,1,0.51,1.96
1000,1000,0,1,0.51,1.96
1000,1000,0,1,0.51,1.96
1000,1000,0,1,0.51,1.96
1000,1000,0,1,0.51,1.96
1000,1000,0,1,0.51,1.96
1000,1000,0,1,0.51,1.96
1000,1000,0,1,0.51,1.96
1000,1000,0,1,0.51,1.96
1000,1000,0,1,0.51,1.96
1000,1000,0,1,0.51,1.96
1000,1000,0,1,0.51,1.96
1000,1000,0,1,0.51,1.96
1000,1000,0,1,0.51,1.96
1000,1000,0,1,0.51,1.96
1000,1000,0,1,0.51,1.96
1000,1000,0,1,0.51,1.96
1000,1000,0,1,0.51,1.96
1000,1000,0,1,0.51,1.96
1000,1000,0,1,0.51,1.96
1000,1000,0,1,0.51,1.96
1000,1000,0,1,0.51,1.96
1000,1000,0,1,0.51,1.96
1000,1000,0,1,0.51,1.96
1000,1000,0,1,0.51,1.96
1000,1000,0,1,0.51,1.96
1000,1000,0,1,0.51,1.96
1000,1000,0,1,0.51,1.96
1000,1000,0,1,0.51,1.96
1000,1000,0,1,0.51,1.96
1000,1000,0,1,0.51,1.96
1000,1000,0,1,0.51,1.96
1000,1000,0,1,0.51,1.96
1000,1000,0,1,0.51,1.96
1000,1000,0,1,0.51,1.96
1000,1000,0,1,0.51,1.96
1000,1000,0,1,0.51,1.96
1000,1000,0,1,0.51,1.96
1000,1000,0,1,0.51,1.96
1000,1000,0,1,0.51,1.96
1000,1000,0,1,0.51,1.96
1000,1000,0,1,0.51,1.96
1000,1000,0,1,0.51,1.96
1000,1000,0,1,0.51,1.96
1000,1000,0,1,0.51,1.96
1000,1000,0,1,0.51,1.96
1000,1000,0,1,0.51,1.96
1000,1000,0,1,0.51,1.96
1000,1000,0,1,0.51,1.96
1000,1000,0,1,0.51,1.96
1000,1000,0,1,0.51,1.96
1000,1000,0,1,0.51,1.96
1000,1000,0,1,0.51,1.96
1000,1000,0,1,0.51,1.96
1000,1000,0,1,0.51,1.96
player1_id,player2_id,atp_difference,classe,proba,odds
100,103,3,0,0.49,2.04
198,14,-184,1,0.58,1.72
30,93,63,0,0.44,2.27
29,119,90,0,0.47,2.13
431,32,-399,1,0.6,1.67
16,138,122,1,0.51,1.96
112,35,-77,0,0.48,2.08
88,94,6,0,0.49,2.04
8,98,90,1,0.65,1.54
55,2,-53,1,0.84,1.19
90,34,-56,1,0.52,1.92
148,17,-131,1,0.58,1.72
66,65,-1,0,0.48,2.08
62,72,10,0,0.49,2.04
31,49,18,0,0.5,2.0
160,18,-142,1,0.54,1.85
63,47,-16,0,0.49,2.04
110,27,-83,0,0.44,2.27
28,43,15,0,0.47,2.13
37,46,9,1,0.52,1.92
122,97,-25,1,0.51,1.96
19,80,61,0,0.43,2.33
133,104,-29,1,0.54,1.85
7,71,64,0,0.5,2.0
1,1000,999,0,0.24,4.17
1000,1000,0,1,0.51,1.96
1000,1000,0,1,0.51,1.96
40,1000,960,0,0.3,3.33
13,1000,987,0,0.3,3.33
1000,1000,0,1,0.51,1.96
1000,1000,0,1,0.51,1.96
1000,1000,0,1,0.51,1.96
1000,1000,0,1,0.51,1.96
1000,1000,0,1,0.51,1.96
1000,1000,0,1,0.51,1.96
1000,1000,0,1,0.51,1.96
1000,1000,0,1,0.51,1.96
1000,1000,0,1,0.51,1.96
1000,1000,0,1,0.51,1.96
1000,1000,0,1,0.51,1.96
1000,1000,0,1,0.51,1.96
123,5,-118,0,0.37,2.7
1000,1000,0,1,0.51,1.96
79,1000,921,0,0.34,2.94
68,187,119,0,0.38,2.63
82,1000,918,0,0.43,2.33
1000,1000,0,1,0.51,1.96
1000,1000,0,1,0.51,1.96
1000,1000,0,1,0.51,1.96
1000,1000,0,1,0.51,1.96
1000,1000,0,1,0.51,1.96
1000,1000,0,1,0.51,1.96
1000,1000,0,1,0.51,1.96
1000,1000,0,1,0.51,1.96
1000,1000,0,1,0.51,1.96
1000,1000,0,1,0.51,1.96
1000,1000,0,1,0.51,1.96
1000,1000,0,1,0.51,1.96
1000,1000,0,1,0.51,1.96
1000,1000,0,1,0.51,1.96
1000,1000,0,1,0.51,1.96
1000,1000,0,1,0.51,1.96
1000,1000,0,1,0.51,1.96
1000,1000,0,1,0.51,1.96
1000,1000,0,1,0.51,1.96
1000,1000,0,1,0.51,1.96
1000,1000,0,1,0.51,1.96
1000,1000,0,1,0.51,1.96
1000,1000,0,1,0.51,1.96
1000,1000,0,1,0.51,1.96
1000,1000,0,1,0.51,1.96
1000,1000,0,1,0.51,1.96
1000,1000,0,1,0.51,1.96
1000,1000,0,1,0.51,1.96
1000,1000,0,1,0.51,1.96
1000,1000,0,1,0.51,1.96
1000,1000,0,1,0.51,1.96
1000,1000,0,1,0.51,1.96
1000,1000,0,1,0.51,1.96
1000,1000,0,1,0.51,1.96
1000,1000,0,1,0.51,1.96
1000,1000,0,1,0.51,1.96
1000,1000,0,1,0.51,1.96
1000,1000,0,1,0.51,1.96
1000,1000,0,1,0.51,1.96
1000,1000,0,1,0.51,1.96
1000,1000,0,1,0.51,1.96
1000,1000,0,1,0.51,1.96
1000,1000,0,1,0.51,1.96
1000,1000,0,1,0.51,1.96
1000,1000,0,1,0.51,1.96
1000,1000,0,1,0.51,1.96
1000,1000,0,1,0.51,1.96
1000,1000,0,1,0.51,1.96
1000,1000,0,1,0.51,1.96
1000,1000,0,1,0.51,1.96
1000,1000,0,1,0.51,1.96
1000,1000,0,1,0.51,1.96
1000,1000,0,1,0.51,1.96
1000,1000,0,1,0.51,1.96
1000,1000,0,1,0.51,1.96
1000,1000,0,1,0.51,1.96
1000,1000,0,1,0.51,1.96
1000,1000,0,1,0.51,1.96
1000,1000,0,1,0.51,1.96
1000,1000,0,1,0.51,1.96
1000,1000,0,1,0.51,1.96
1000,1000,0,1,0.51,1.96
1000,1000,0,1,0.51,1.96
1000,1000,0,1,0.51,1.96
1000,1000,0,1,0.51,1.96
1000,1000,0,1,0.51,1.96
1000,1000,0,1,0.51,1.96
1000,1000,0,1,0.51,1.96
1000,1000,0,1,0.51,1.96
1000,1000,0,1,0.51,1.96
1000,1000,0,1,0.51,1.96
1000,1000,0,1,0.51,1.96
1000,1000,0,1,0.51,1.96
1000,1000,0,1,0.51,1.96
1000,1000,0,1,0.51,1.96
1000,1000,0,1,0.51,1.96
1000,1000,0,1,0.51,1.96
1000,1000,0,1,0.51,1.96
1000,1000,0,1,0.51,1.96
1000,1000,0,1,0.51,1.96
1000,1000,0,1,0.51,1.96
1000,1000,0,1,0.51,1.96
1000,1000,0,1,0.51,1.96
1000,1000,0,1,0.51,1.96
1000,1000,0,1,0.51,1.96
1000,1000,0,1,0.51,1.96
1000,1000,0,1,0.51,1.96
1000,1000,0,1,0.51,1.96
1000,1000,0,1,0.51,1.96
1000,1000,0,1,0.51,1.96
1000,1000,0,1,0.51,1.96
1000,1000,0,1,0.51,1.96
1000,1000,0,1,0.51,1.96
1000,1000,0,1,0.51,1.96
1000,1000,0,1,0.51,1.96
1000,1000,0,1,0.51,1.96
1000,1000,0,1,0.51,1.96
1000,1000,0,1,0.51,1.96
1000,1000,0,1,0.51,1.96
1000,1000,0,1,0.51,1.96
player1_id,player2_id,atp_difference,classe,proba,odds
1000,1000,0,1,0.5,2.0
1000,1000,0,1,0.5,2.0
1000,1000,0,1,0.5,2.0
1000,1000,0,1,0.5,2.0
1000,1000,0,1,0.5,2.0
1000,1000,0,1,0.5,2.0
1000,1000,0,1,0.5,2.0
1000,1000,0,1,0.5,2.0
1000,1000,0,1,0.5,2.0
1000,1000,0,1,0.5,2.0
1000,1000,0,1,0.5,2.0
1000,1000,0,1,0.5,2.0
1000,1000,0,1,0.5,2.0
1000,1000,0,1,0.5,2.0
1000,1000,0,1,0.5,2.0
1000,1000,0,1,0.5,2.0
1000,1000,0,1,0.5,2.0
1000,1000,0,1,0.5,2.0
1000,1000,0,1,0.5,2.0
1000,1000,0,1,0.5,2.0
1000,1000,0,1,0.5,2.0
1000,1000,0,1,0.5,2.0
1000,1000,0,1,0.5,2.0
1000,1000,0,1,0.5,2.0
1000,1000,0,1,0.5,2.0
1000,1000,0,1,0.5,2.0
1000,1000,0,1,0.5,2.0
1000,1000,0,1,0.5,2.0
1000,1000,0,1,0.5,2.0
1000,1000,0,1,0.5,2.0
1000,1000,0,1,0.5,2.0
1000,1000,0,1,0.5,2.0
1000,1000,0,1,0.5,2.0
1000,1000,0,1,0.5,2.0
1000,1000,0,1,0.5,2.0
1000,1000,0,1,0.5,2.0
1000,1000,0,1,0.5,2.0
1000,1000,0,1,0.5,2.0
1000,1000,0,1,0.5,2.0
1000,1000,0,1,0.5,2.0
1000,1000,0,1,0.5,2.0
1000,1000,0,1,0.5,2.0
1000,1000,0,1,0.5,2.0
player1_id,player2_id,atp_difference,classe,proba,odds
1000,1000,0,1,0.5,2.0
1000,1000,0,1,0.5,2.0
1000,1000,0,1,0.5,2.0
1000,1000,0,1,0.5,2.0
1000,1000,0,1,0.5,2.0
1000,1000,0,1,0.5,2.0
1000,1000,0,1,0.5,2.0
1000,1000,0,1,0.5,2.0
1000,1000,0,1,0.5,2.0
1000,1000,0,1,0.5,2.0
1000,1000,0,1,0.5,2.0
1000,1000,0,1,0.5,2.0
1000,1000,0,1,0.5,2.0
1000,1000,0,1,0.5,2.0
1000,1000,0,1,0.5,2.0
1000,1000,0,1,0.5,2.0
1000,1000,0,1,0.5,2.0
1000,1000,0,1,0.5,2.0
1000,1000,0,1,0.5,2.0
1000,1000,0,1,0.5,2.0
1000,1000,0,1,0.5,2.0
1000,1000,0,1,0.5,2.0
1000,1000,0,1,0.5,2.0
1000,1000,0,1,0.5,2.0
1000,1000,0,1,0.5,2.0
1000,1000,0,1,0.5,2.0
1000,1000,0,1,0.5,2.0
1000,1000,0,1,0.5,2.0
1000,1000,0,1,0.5,2.0
1000,1000,0,1,0.5,2.0
1000,1000,0,1,0.5,2.0
1000,1000,0,1,0.5,2.0
1000,1000,0,1,0.5,2.0
1000,1000,0,1,0.5,2.0
1000,1000,0,1,0.5,2.0
1000,1000,0,1,0.5,2.0
1000,1000,0,1,0.5,2.0
1000,1000,0,1,0.5,2.0
1000,1000,0,1,0.5,2.0
1000,1000,0,1,0.5,2.0
1000,1000,0,1,0.5,2.0
1000,1000,0,1,0.5,2.0
1000,1000,0,1,0.5,2.0
player1_id,player2_id,atp_difference,classe,proba,odds
1000,1000,0,0,0.5,2.0
1000,1000,0,0,0.5,2.0
1000,1000,0,0,0.5,2.0
1000,1000,0,0,0.5,2.0
1000,1000,0,0,0.5,2.0
1000,1000,0,0,0.5,2.0
1000,1000,0,0,0.5,2.0
1000,1000,0,0,0.5,2.0
1000,1000,0,0,0.5,2.0
1000,1000,0,0,0.5,2.0
1000,1000,0,0,0.5,2.0
1000,1000,0,0,0.5,2.0
1000,1000,0,0,0.5,2.0
1000,1000,0,0,0.5,2.0
1000,1000,0,0,0.5,2.0
1000,1000,0,0,0.5,2.0
1000,1000,0,0,0.5,2.0
1000,1000,0,0,0.5,2.0
1000,1000,0,0,0.5,2.0
1000,1000,0,0,0.5,2.0
1000,1000,0,0,0.5,2.0
1000,1000,0,0,0.5,2.0
1000,1000,0,0,0.5,2.0
1000,1000,0,0,0.5,2.0
1000,1000,0,0,0.5,2.0
1000,1000,0,0,0.5,2.0
1000,1000,0,0,0.5,2.0
1000,1000,0,0,0.5,2.0
1000,1000,0,0,0.5,2.0
1000,1000,0,0,0.5,2.0
1000,1000,0,0,0.5,2.0
1000,1000,0,0,0.5,2.0
1000,1000,0,0,0.5,2.0
1000,1000,0,0,0.5,2.0
1000,1000,0,0,0.5,2.0
1000,1000,0,0,0.5,2.0
1000,1000,0,0,0.5,2.0
1000,1000,0,0,0.5,2.0
1000,1000,0,0,0.5,2.0
1000,1000,0,0,0.5,2.0
1000,1000,0,0,0.5,2.0
1000,1000,0,0,0.5,2.0
1000,1000,0,0,0.5,2.0
player1_id,player2_id,atp_difference,classe,proba,odds
1000,1000,0,1,0.5,2.0
1000,1000,0,1,0.5,2.0
1000,1000,0,1,0.5,2.0
1000,1000,0,1,0.5,2.0
1000,1000,0,1,0.5,2.0
1000,1000,0,1,0.5,2.0
1000,1000,0,1,0.5,2.0
1000,1000,0,1,0.5,2.0
1000,1000,0,1,0.5,2.0
1000,1000,0,1,0.5,2.0
1000,1000,0,1,0.5,2.0
1000,1000,0,1,0.5,2.0
1000,1000,0,1,0.5,2.0
1000,1000,0,1,0.5,2.0
1000,1000,0,1,0.5,2.0
1000,1000,0,1,0.5,2.0
1000,1000,0,1,0.5,2.0
1000,1000,0,1,0.5,2.0
1000,1000,0,1,0.5,2.0
1000,1000,0,1,0.5,2.0
1000,1000,0,1,0.5,2.0
1000,1000,0,1,0.5,2.0
1000,1000,0,1,0.5,2.0
1000,1000,0,1,0.5,2.0
1000,1000,0,1,0.5,2.0
1000,1000,0,1,0.5,2.0
1000,1000,0,1,0.5,2.0
1000,1000,0,1,0.5,2.0
1000,1000,0,1,0.5,2.0
1000,1000,0,1,0.5,2.0
1000,1000,0,1,0.5,2.0
1000,1000,0,1,0.5,2.0
1000,1000,0,1,0.5,2.0
1000,1000,0,1,0.5,2.0
1000,1000,0,1,0.5,2.0
1000,1000,0,1,0.5,2.0
1000,1000,0,1,0.5,2.0
1000,1000,0,1,0.5,2.0
1000,1000,0,1,0.5,2.0
1000,1000,0,1,0.5,2.0
1000,1000,0,1,0.5,2.0
1000,1000,0,1,0.5,2.0
1000,1000,0,1,0.5,2.0
player1_id,player2_id,atp_difference,classe,proba,odds
1000,1000,0,1,0.5,2.0
1000,1000,0,1,0.5,2.0
1000,1000,0,1,0.5,2.0
1000,1000,0,1,0.5,2.0
1000,1000,0,1,0.5,2.0
1000,1000,0,1,0.5,2.0
1000,1000,0,1,0.5,2.0
1000,1000,0,1,0.5,2.0
1000,1000,0,1,0.5,2.0
1000,1000,0,1,0.5,2.0
1000,1000,0,1,0.5,2.0
1000,1000,0,1,0.5,2.0
1000,1000,0,1,0.5,2.0
1000,1000,0,1,0.5,2.0
1000,1000,0,1,0.5,2.0
1000,1000,0,1,0.5,2.0
1000,1000,0,1,0.5,2.0
1000,1000,0,1,0.5,2.0
1000,1000,0,1,0.5,2.0
1000,1000,0,1,0.5,2.0
1000,1000,0,1,0.5,2.0
1000,1000,0,1,0.5,2.0
1000,1000,0,1,0.5,2.0
1000,1000,0,1,0.5,2.0
1000,1000,0,1,0.5,2.0
1000,1000,0,1,0.5,2.0
1000,1000,0,1,0.5,2.0
1000,1000,0,1,0.5,2.0
1000,1000,0,1,0.5,2.0
1000,1000,0,1,0.5,2.0
1000,1000,0,1,0.5,2.0
1000,1000,0,1,0.5,2.0
1000,1000,0,1,0.5,2.0
1000,1000,0,1,0.5,2.0
1000,1000,0,1,0.5,2.0
1000,1000,0,1,0.5,2.0
1000,1000,0,1,0.5,2.0
1000,1000,0,1,0.5,2.0
1000,1000,0,1,0.5,2.0
1000,1000,0,1,0.5,2.0
1000,1000,0,1,0.5,2.0
1000,1000,0,1,0.5,2.0
1000,1000,0,1,0.5,2.0
player1_id,player2_id,atp_difference,classe,proba,odds
1000,1000,0,0,0.5,2.0
1000,1000,0,0,0.5,2.0
1000,1000,0,0,0.5,2.0
1000,1000,0,0,0.5,2.0
1000,1000,0,0,0.5,2.0
1000,1000,0,0,0.5,2.0
1000,1000,0,0,0.5,2.0
1000,1000,0,0,0.5,2.0
1000,1000,0,0,0.5,2.0
1000,1000,0,0,0.5,2.0
1000,1000,0,0,0.5,2.0
1000,1000,0,0,0.5,2.0
1000,1000,0,0,0.5,2.0
1000,1000,0,0,0.5,2.0
1000,1000,0,0,0.5,2.0
1000,1000,0,0,0.5,2.0
1000,1000,0,0,0.5,2.0
1000,1000,0,0,0.5,2.0
1000,1000,0,0,0.5,2.0
1000,1000,0,0,0.5,2.0
1000,1000,0,0,0.5,2.0
1000,1000,0,0,0.5,2.0
1000,1000,0,0,0.5,2.0
1000,1000,0,0,0.5,2.0
1000,1000,0,0,0.5,2.0
1000,1000,0,0,0.5,2.0
1000,1000,0,0,0.5,2.0
1000,1000,0,0,0.5,2.0
1000,1000,0,0,0.5,2.0
1000,1000,0,0,0.5,2.0
1000,1000,0,0,0.5,2.0
1000,1000,0,0,0.5,2.0
1000,1000,0,0,0.5,2.0
1000,1000,0,0,0.5,2.0
1000,1000,0,0,0.5,2.0
1000,1000,0,0,0.5,2.0
1000,1000,0,0,0.5,2.0
1000,1000,0,0,0.5,2.0
1000,1000,0,0,0.5,2.0
1000,1000,0,0,0.5,2.0
1000,1000,0,0,0.5,2.0
1000,1000,0,0,0.5,2.0
1000,1000,0,0,0.5,2.0
player1_id,player2_id,atp_difference,classe,proba,odds
1000,1000,0,0,0.5,2.0
1000,1000,0,0,0.5,2.0
1000,1000,0,0,0.5,2.0
1000,1000,0,0,0.5,2.0
1000,1000,0,0,0.5,2.0
1000,1000,0,0,0.5,2.0
1000,1000,0,0,0.5,2.0
1000,1000,0,0,0.5,2.0
1000,1000,0,0,0.5,2.0
1000,1000,0,0,0.5,2.0
1000,1000,0,0,0.5,2.0
1000,1000,0,0,0.5,2.0
1000,1000,0,0,0.5,2.0
1000,1000,0,0,0.5,2.0
1000,1000,0,0,0.5,2.0
1000,1000,0,0,0.5,2.0
1000,1000,0,0,0.5,2.0
1000,1000,0,0,0.5,2.0
1000,1000,0,0,0.5,2.0
1000,1000,0,0,0.5,2.0
1000,1000,0,0,0.5,2.0
1000,1000,0,0,0.5,2.0
1000,1000,0,0,0.5,2.0
1000,1000,0,0,0.5,2.0
1000,1000,0,0,0.5,2.0
1000,1000,0,0,0.5,2.0
1000,1000,0,0,0.5,2.0
1000,1000,0,0,0.5,2.0
1000,1000,0,0,0.5,2.0
1000,1000,0,0,0.5,2.0
1000,1000,0,0,0.5,2.0
1000,1000,0,0,0.5,2.0
1000,1000,0,0,0.5,2.0
1000,1000,0,0,0.5,2.0
1000,1000,0,0,0.5,2.0
1000,1000,0,0,0.5,2.0
1000,1000,0,0,0.5,2.0
1000,1000,0,0,0.5,2.0
1000,1000,0,0,0.5,2.0
1000,1000,0,0,0.5,2.0
1000,1000,0,0,0.5,2.0
1000,1000,0,0,0.5,2.0
1000,1000,0,0,0.5,2.0
